%%%%%%%%%%%%%%%%%%%%%%%%%%%%%%
%.% %   %    %     %        .%
%       % % %%%%%% %  %%%%   %
% %%% %%%%% % % %   %     %%%%
%   % % %   % %%% % %%% % % %%
% %%% % % %%%%% % % % % % %%%%
%       % % %   %   % % %    %
%%% % %%%%%%% % %%%%%%% % %  %
% %           %%     %     % %
% % %%%%% % %%%% % %%% %%% % %
%   %     %      %     % %%% %
%.  %P%%%%%      % %%% %    .%
%%%%%%%%%%%%%%%%%%%%%%%%%%%%%%