%%%%%%%%%%%%%%%%%%%%%%%%%%%%%%
%.% %   %    %     %   % % %.%
%       % % %%%%%%           %
% %%% %%%%% % % %   % % % %%%%
%   % % %   % %%% % %%% % % %%
% %%% % % %%%%% % % % % % %%%%
%       %     %   %   % % %  %
%%% % %%%%%%% % %%%%%%% % % %%
% %           %      %       %
% % %%%%% % %%%% % %%% %%% % %
%   %     %      % %   % %%% %
%.  %P%%%%%      % %%% %    .%
%%%%%%%%%%%%%%%%%%%%%%%%%%%%%%
