%%%%%%%%%%%%%%%%%%%%%%%%%%%%%%
%.      %    %     %    %   .%
% %%% % %%%%%% %%% %% % % %%%%
% %            %      %      %
% % % %%%%% % % % %%%% %%%%% %
%   %  %    %P %   %     %   %
%%%%%% % %%%%% % % % %% %% % %
%.       %  %    %    %    %.%
%%%%%%%%%%%%%%%%%%%%%%%%%%%%%%
