%%%%%%%%%%%%%%%%%%%%%%%%%%%%%%
%.% %   %    %     %   %%   .%
% %%%%     %%%%%%%% % % % %%%%
%     % % % %   % % % % %    %
% %%%   %           %    %%  %
% %   %%%%%%%%% % %%% %%     %
%%% %%%%% %   % % %   % %%%  %
%%      %   %   %     %      %
%%  % %%%%% % % % % % %%%%%  %
%   %     % % % % % %     %  %
%.  %P%%%%% % % % % % %%% % .%
%%%%%%%%%%%%%%%%%%%%%%%%%%%%%%
