%%%%%
%. .%
%%% %
%. P%
%%%%%
