%%%%%%%%%%%%%%%%%%%%
%.           ..%   %
%.%%.%%.%%.%%.%% % %
%  .     .       % %
%%%%%%%%%%%%%%%%%% %
%.....            P%
%%%%%%%%%%%%%%%%%%%%
