%%%%%%%%%%%%%%%%%%%%
%. .    .      %  P%
%.%% %%.%% %%.%% % %
%                % %
%%%%%%%%%%%%%%%%%% %
%.  .           . .%
%%%%%%%%%%%%%%%%%%%%
