%%%%%%%%%%%%%%%%%%%%
%.            .%  .%
%%%%%%%.%% %%%%%%% %
%  .     .   P     %
%%%%%%%%%%%%%%%%%% %
%.              .  %
%%%%%%%%%%%%%%%%%%%%
