%%%%%%%%%%%%%%%%%%%%
%. %.   %%   .%%%. %
%% %%%%.%% %%%%%%% %
%  .     .   P     %
%%%%%%.%%%%%%%%%%% %
%.              .  %
%%%%%%%%%%%%%%%%%%%%
